1111111111
1000100001
1000100001
1001110001
1000100001
1000100001
1000000001
1011100001
1000100001
1111111111